###############
#             #
#  #########  #
#  #       #  #
#  #  ###  #  #
#  #  # #  #  #
#  #  ###  #  #
#  #       #  #
#  #########  #
#             #
###############
