#####################
#    #    #    #    #
#    #    #    #    #
#### # #### #### ####
#    #    #    #    #
#    #    #    #    #
#### #### # #### ####
#         #         #
#####################
