##########
#        #
#  ## #  #
#  #  #  #
#  #     #
#  ####  #
#        #
##########
